################
#.............W#
#...........G..#
#..............#
#..............#
#..............#
#..............#
#..............#
#..P...........#
#L.............#
################
