################
#............###
#.#M#######....#
#.#..#....#....#
#.#..#.P..#....#
#.#G.#....#....#
#.####.M..###M##
#.#L.#.........#
#.##.#########.#
#............#L#
################