#########################
#P..........#..........#
#..C........#..........#
#...........#..........#
#...M.......T:5..........#
#...........#..........#
#W..........#.......C..#
#...........#..........#
#...........#..........#
#####*******#..........#
#...L.......#.........G#
#########################

