#####################
#P.....#...........#
#......#...........#
#......#...........#
#......#....C......#
#......#...........#
#......#...........#
#......#...........#
#L.....#..........G#
#####################

