################
#............###
#..............#
#.#M#######....#
#.#..#....#....#
#.#..#....#.L..#
#.#G.#....#....#
#.####....###M##
#.#L.#.........#
#.##.#########.#
#............#L#
################