#################
#...#........#W##
#.G.#......M.#T:13##
#...#...........#
#.####*.........#
#.T:34LT:28.......P...#
#.####*.........#
#...#...........#
#...T:34......M....#
#...#...........#
#################

