#####################
#P.....T:3.........#
#......T:3.........#
#......T:3.........#
#....M.***....C....#
#......***....W....#
#......***........##
#..................#
#L.................G#
#####################

