################
#........#######
#.P...........G#
#........#######
#........#.....#
##.......#..L..#
###.L....#.....#
################
