#################
#...#........#W##
#.G.#......M.#T##
#...#...........#
#.####*.........#
#.TLT.......P...#
#.####*.........#
#...#...........#
#...T......M....#
#...#...........#
#################

