#####################
#P................C#
#.................##
#......M..........##
#.................##
#.....W...........##
#.................##
#.................G#
#####################

