################
#W.#...........#
#..#....M....C.#
####...........#
#.....#####..###
#.G.P.T:30L#LT:14..###
#.....#####..###
####...........#
#..#....M....C.#
#W.#...........#
################
