################
#..........L...#
#......#########
#............#G#
#..............#
#..............#
#.....M........#
#...##W##......#
#.P.#WWW#......#
#...#WWW#......#
################