################
##L..........#W#
#########.P..###
##L#......M...##
##.#..........##
##.#.C....M.G.##
##.#..........##
##.#..........##
##.#######...###
##...........#W#
################