#####################
#P.........C.......#
#..................#
#....M.....M.......#
#..................#
#......L...........#
#..................#
#..................#
#..................G#
#####################

