###############
#L.#........G.#
#L.##.........#
#L.........####
#L.##....M....#
#L.#.......##.#
#L.#.M......#.#
#L.#........#.#
#L.#.P......#.#
#L.#........#L#
###############
