################
#..............#
#.#####..#####.#
#....LM..ML....#
##M####..####M##
#..####..####..#
#C.#..#P.#..#.G#
####.M....M.####
#..#........#..#
#..#........#..#
################
