################
#......G.....###
#.C...........##
#..............#
#......M.......#
#.P...MWM.....L#
#......M.......#
#..............#
#.C...........##
#............###
################